############################
##.....#####...#############
##........##.P.###....######
##.....##.##...######.######
####.####.###.#######.#....#
####.####..........##......#
####.########.####.####....#
##.....###########.####....#
##.................######.##
##.....##################.##
####.#########........###.##
####.#########........###.##
####.##.....##........###.##
##.............###.######.##
#######.....######.######.##
####.####.######.....####.##
####.####.######..........##
####.####.....##.....####.##
##....###.###.####.######.##
##.##.###.###.####.######.##
##.##.##..................##
##.###############.####.####
##......##............#.####
##.##...##.##.####.####.####
##.##...##.##.####.##.....##
##.##......#.E.###........##
############...#############
############################
