############################
#...#################...####
#...########...######...####
##.####......P.######...####
##.####.####...#######.#####
##......##############.#####
##.###################.#####
##.################.......##
##.########.....###.......##
##......###.....###.......##
###.###.###.....###.......##
###.###.#####.########.#####
##...##.#####.########.#####
##...##.#####.######.....###
##...##.#####.######.###.###
#######..............###.###
#######.############.###.###
#######.############.###.###
##...##.##...#####....##.###
##...........#####....##.###
##...##.##...#####....##.###
#######.################.###
#######.######...........###
######....####.#############
######....####.#############
######....##.....###########
############..E..###########
############################
