############################
############################
############################
###......................###
###.###########.########.###
###.###########.########.###
###.##...#...#...#...###.###
###.##.......#...#...###.###
###.##...#...#...#...###.###
###.#######.###.###.####.###
###.##...##.###.###.#..#.###
###....................#.###
###.##...##.#######.#..#.###
###.###.###.#######.####.###
###.##...#...#...#...###.###
###.##...#.......#...###.###
###.##...#...#...#...###.###
###.###.#######.########.###
###.##...####.....##...#.###
###.##...####..P..##...#.###
###.#################.##.###
###......................###
######.#######.######.######
######.#######.######.######
####.....###.....##.....####
####.....###..E..##.....####
####.....###.....##.....####
############################
